AA	Afar
AB	Abhkazian
AF	Afrikaans
AM	Amarico
AR	¡rabe
AS	Assames
AY	Aimara
AZ	Azerbaidjano
BA	Bashquir
BB	Berbere
BC	Baluchi
BE	Bielo-Russo
BG	B˙lgaro
BH	Bihari
BI	Bislama
BM	BirmanÍs
BN	Bengali
BO	Tibetano
BR	Bret„o
CA	Catal„o
CB	Cabie
CO	Corsico
CR	Crioulo
CS	Tcheco-Eslovaco
CY	GalÍs
DA	DinamarquÍs
DE	Alem„o
DI	Divehi
DZ	Dzongka
EE	Eue
EL	Grego
EN	InglÍs
EO	Esperanto
ES	Espanhol
ET	Estoniano
EU	Basco
FA	Persa
FI	FinlandÍs
FJ	Fijiano
FL	Filipino
FO	FerÛico
FR	FrancÍs
FY	Eris„o
GA	IrlandÍs
GD	Gaelico EscocÍs
GL	Galego
GN	Guarani
GU	Gujarati
HA	Hausa
HI	Hindi
HR	Croata
HU	H˙ngaro
HY	HarmÍnio
IA	InterlÌngua
ID	Ioma
IE	InterlÌngue
IK	Inupiak
IN	IndonÈsio
IS	IslandÍs
IT	Italiano
IW	Hebraico
JA	JaponÍs
JI	Iidiche
JV	JavanÍs
KA	Georgiano
KK	Casaque
KL	GroenlandÍs
KM	Cambodjano
KN	Canad·
KO	Coreano
KS	Cachemiriano
KU	Curdo
KY	Quirquiz
LA	Latim
LN	Ling·la
LO	Laosiano
LP	Lap„o
LT	Lituano
LV	Let„o
LX	LuxemburguÍs
MA	Mandingo
MG	Malgaxe
MI	Maori
MK	MacedÙnio
ML	Malaiala
MN	Mongol
MO	Moldavio
MR	MaratÌ
MS	Malaio
MT	MaltÍs
MY	SirmanÍs
NA	Nauruano
NE	Nepali
NL	HolandÍs
NO	NorueguÍs
OM	Oromo
OR	Oria
OU	Outros
PA	Punjabi
PL	PolonÍs
PS	Pushto
PT	PortuguÍs
QI	Quisuahili
QU	Quichua
RM	Reto-Romano
RN	Quirundi
RO	Romeno
RU	Russo
RW	Quiniaruanda
SA	Sanscrito
SD	Sindi
SG	Sango
SH	Servo-Croata
SI	CingalÍs
SK	Eslovaco
SL	Esloveno
SM	Samoano
SN	Shona
SO	Somali
SQ	AlbanÍs
SR	Serbian
SS	Sisvati
ST	Sesoto
SU	SudanÍs
SV	SuÈco
SW	Suaili
TA	Tamil
TE	Telugo
TG	Tadjique
TH	Tai
TI	Tigrina
TK	Turcomano
TL	Talagog
TN	Setsuana
TO	TongalÍs
TR	Turco
TS	Tsonga
TT	Tatar
TU	Tuvaloano
TW	Tui
UK	Ucrani‚no
UR	Urdu
UZ	Uzbeco
VI	Vietnamita
VO	Volupak
WO	Wolof
XH	Xosa
YO	Yoruba
ZH	ChinÍs
ZU	Zul˙